NO ./assets/textures/shades/deep_square.xpm
SO ./assets/textures/shades/deep_square.xpm
WE ./assets/textures/shades/deep_square.xpm
EA ./assets/textures/shades/deep_square.xpm

C 62,70,186
F 123,131,249

111111111111111111111111111111111111111111111
111111110000000100000001000000000011010001001
111100000000000100010001001111110000010001001
100100111111100001110001001000011100000001001
100100000100000001010111001000011100011111001
100100000101001111010001001110011100000010011
100111000100001001001100000000001111001110011
100000000101011011101100001001101111001000011
100000011101011000101110001001001100000001111
111100011100011000111000001001011111100011111
111100011100011000100000001001011100000011111
1E0000000100000001111111000001000000001111111
111111111111111111111111111111111111111111111