NO ./assets/north.xpm
SO ./assets/south.xpm
WE ./assets/west.xpm
EA ./assets/east.xpm

F 220,100,0
C 225,30,0

  
11111111
10010001
10000W01
10001101
10000001
111110N1
10000011
11111111