NO ./assets/textures/42.xpm
SO ./assets/textures/42.xpm
WE ./assets/textures/42.xpm
EA ./assets/textures/42.xpm
C 102,143,204
F 153,102,255

11111111111111111
10000000000000001
10000000101111101
10000001101000101
10000010001001001
10000100000010001
10001000100100001
10011001101000101
10111111101111101
10000000100000001
1000000010000N001
10000000100000001
10000000000000001
11111111111111111