NO ./assets/textures/high_resolution/turrell.xpm
SO ./assets/textures/high_resolution/turrell.xpm
WE ./assets/textures/high_resolution/turrell.xpm
EA ./assets/textures/high_resolution/turrell.xpm
C 23,44,240
F 30,39,124
  
11111111111111111
10000000S00000001
10000000000000001
10000001110000001
10000001110000001
10000111111100001
10000001110000001
10000001110000001
10000000000000001
10000000000000001
11111111111111111