NO ./assets/textures/shades/dark_purple_shades.xpm
SO ./assets/textures/shades/pink_shades.xpm
WE ./assets/textures/shades/low_purple_shades.xpm
EA ./assets/textures/shades/purple_to_white.xpm
C 89,0,107
F 107,39,152

11111111111111111
10000000000000001
10001110001110001
10010001010001001
10100000100000101
10100000000000101
10100000000000101
10100000N00000101
10010000000001001
10001000000010001
10000100000100001
10000010001000001
10000001010000001
10000000100000001
10000000000000001
11111111111111111
