F 0,220,100

C 62,70,186
NO ./assets/map/invalid/folder.xpm
SO ./assets/textures/shades/deep_square.xpm
EA ./assets/textures/shades/deep_square.xpm
WE ./assets/textures/shades/deep_square.xpm


11111111111
10000000001
100000S0001
10000000001
11111111111