NO ./assets/textures/shades/deep_square.xpm
SO ./assets/textures/shades/deep_square.xpm
WE ./assets/textures/shades/deep_square.xpm
EA ./assets/textures/shades/deep_square.xpm
DO ./assets/textures/shades/door_square.xpm

C 62,70,186
F 123,131,249
S 33,26,216/148,39,141/14,128,185

11111111111111111111111111111
100000000000100000000000001S1
10111111111010011111011040101
10101000000000020001010010101
10101011111111110001110010101
10101000100000011111011111101
10001111301111000000000000101
10101000101001111110101110101
10101110101001000000100010101
10100010101011010001511110001
10111110101001011111000011111
10000010000000000000011010001
10111010101011111111001010101
10001000101010000000001000101
1111111111111111111111111111