NO ./assets/textures/shades/deep_square.xpm
SO ./assets/textures/shades/deep_square.xpm
WE ./assets/textures/shades/deep_square.xpm
EA ./assets/textures/shades/deep_square.xpm

DO ./assets/textures/shades/door_square.xpm

S 255,153,40/255,102,255/255,227,37

C 62,70,186
F 133,76,255

 11111
 10001
 10001
 10001
1112111
10000W1
1000001
1304051
1111111