NO ./assets/textures/shades/deep_square.xpm
SO ./assets/textures/shades/deep_square.xpm
WE ./assets/textures/shades/deep_square.xpm
EA ./assets/textures/shades/deep_square.xpm

SP ./assets/sprites/42.xpm

C 62,70,186
F 123,131,249

111111
1E0021
100001
111111