NO ./assets/textures/shades/pixel_0.xpm
SO ./assets/textures/shades/pixel_1.xpm
WE ./assets/textures/shades/pixel_2.xpm
EA ./assets/textures/shades/pixel_3.xpm
F 89,0,152
C 107,39,152

111111111111111111111111111111111111111111111
1S1000100010001000100010001000100010001000101
101010101010101010101010101010101010101010101
100010001000100010001000100010001000100010001
111111111111111111111111111111111111111111111