NO ./assets/textures/shades/pixel_0.xpm
SO ./assets/textures/shades/pixel_1.xpm
WE ./assets/textures/shades/pixel_2.xpm
EA ./assets/textures/shades/pixel_3.xpm
C 89,0,107
F 107,39,152

111111111111111111111111111111111111111111111
1001001000000000000010000100000001010001E0001
110100001001011111111001111111100101000111001
100111111001000100101000000000100001001100011
100000000001000100101001111100111001000111001
100001100111000100101101000000000000000111001
110001100001001100000101111110000111111100001
101111100011000000100100000011100000100000111
100100100011000011100111000100000011111000011
100100000111000000100000000100000000000011111
111111111111111111111111111111111111111111111
