NO ./assets/textures/shades/deep_square.xpm
SO ./assets/textures/shades/deep_square.xpm
WE ./assets/textures/shades/deep_square.xpm
EA ./assets/textures/shades/deep_square.xpm

C 62,70,186
F 123,131,249

11111111111111111111111111111
100000000000100000000000001S1
10111111111010011110011010101
10101000000000010000010010101
10101011111111110001110010101
10101000100000011111011111101
10001111101111000000000000101
10101000001001111110101110101
10101110101001000000100010101
10100010101011010001111110001
10111110101001011111000011111
10000010100000000000011010001
10111010101011111111001010101
10001000101010000000001000101
1111111111111111111111111111