NO ./assets/shades_north.xpm
SO ./assets/shades_south.xpm
WE ./assets/shades_west.xpm
EA ./assets/shades_east.xpm

C 62,70,186
F 123,131,249


11111111
10010001
10000001
10001001
10000001
11111001
1E000001
11111111