NO ./assets/north.xpm
SO ./assets/woman.xpm
WE ./assets/wolf.xpm
EA ./assets/east.xpm

F 220,100,0
C 225,30,0


11111111
10010001
10000001
10001001
10000001
11111001
10000001
11111111
